00000000000000000000
00000000000000000000
00000000000000000000
00001110001000111000
00001000000000001000
00001000000000001000
00000000000000000000
00000000000000000000
00001000000000001000
00001000000000001000
00001111001000111000
00000000000000000000
00000000000000000000
00000000000000000000