00000000000000000000
00000000000000000000
00000000000000000000
00000111100011110000
00000000000000010000
00000000000000010000
00000000000011110000
00011110000000000000
00010000000000000000
00010000000000000000
00011100111100000000
00000000000000000000
00000000000000000000
00000000000000000000
