00000000000000000000
00000000000000000000
00000000000000000000
00002222222222222200
00000000000000000000
00000000000000000000
00000000000000000000
00001000000000000100
00001100000000001100
00001100000000001100
00000110000000011000
00000000000000000000
00000000000000000000
00000000000000000000
