00000000000000000000
00000000000000000000
00000000000000000000
00000111111111110000
00000000000000010000
00001111001111000000
00001000000000010000
00000000111100110000
00001000000000000000
00001110011110000000
00001000000000000000
00001001100000000000
00000000000000000000
00000000000000000000
