00000000000000000000
00000000020000000000
00000010020010000000
00000110020011000000
00001100020001100000
00011000020000110000
00000000020000000000
00000000020000000000
00011000020000110000
00001100020001100000
00000110020011000000
00000010020010000000
00000000020000000000
00000000000000000000