00000000000000000000
00000000000000000000
00000000000000000000
00000111111111000000
00000100000001000000
00000100000001000000
00000100000000000000
00000100000001000000
00000111100111000000
00000100000000000000
00000100000000000000
00000100000000000000
00000000000000000000
00000000000000000000