00000000000000000000
00000000100000000000
00000000000000000000
00000000000000000000
00010000000001000000
00011000000011000000
00000000000000000000
00000010001000000000
00000001110000000000
00000110001100000000
00000100000100000000
00000000000000000000
00000000010000000000
00000000000000000000