00000000000000000000
00000000000000000000
00000000000000000000
00001111111110000000
00001000000010000000
00001000000010000000
00001000000000000000
00001000000010000000
00001111001110000000
00001000000000000000
00001000000000000000
00001000000000000000
00000000000000000000
00000000000000000000